wwwwwwwwwwwwwwwwwwwwwwwwwwwwwww
w.............................w
w.............................w
wl.i.......................b.lw
wwwwwws................swwwwwww
w.....s................s......w
w.....swwwwwwwwwwwwwwwws......w
w..g..s................s...g..w
wwwwwwwwwwwwwwwwwwwwwwwwwwwwwww