wwwwwwwwwwwwwwwwwwww
w............l.....w
w............wwws..w
w...............s..w
w...............s..w
w...............s..w
w...............s..w
w...............s..w
w..i.........b..s..w
w..wwswwwwww.wwww..w
w....swwwwwwww.....w
w....s...ww........w
w....s.............w
w.m..s.m....m....g.w
wwwwwwwwwwwwwwwwwwww